40
40
0,0,0,0,0,13,0,0,0,0,0,0,0,0,0,0,0,0,0,0,0,0,0,0,0,0,0,0,0,0,0,0,0,0,0,0,0,0,0,0,
0,0,0,245,0,13,0,0,0,0,0,1,1,1,1,1,1,1,1,1,1,1,1,1,1,1,1,0,0,0,0,0,0,0,0,0,0,0,0,0,
20,0,8,9,9,10,0,0,0,0,0,1,1,15,15,15,15,15,15,15,15,15,15,15,15,15,1,1,1,1,1,1,1,1,1,1,1,0,0,0,
16,0,12,1,1,1,1,1,1,1,1,1,16,0,0,0,0,0,0,0,0,0,0,0,0,0,11,15,15,15,15,15,15,1,1,1,1,1,1,1,
16,0,11,15,15,15,15,15,15,15,15,15,18,0,0,0,0,0,0,0,0,0,0,0,0,0,0,0,0,0,0,0,0,11,15,15,15,15,15,15,
16,0,0,0,0,37,0,0,0,0,0,0,160,0,0,0,0,0,0,0,0,0,0,0,0,0,0,0,0,0,0,0,0,0,0,0,0,0,37,159,
17,0,0,0,0,37,0,0,202,0,0,0,160,0,0,0,0,114,0,0,202,0,0,0,0,0,0,0,0,0,0,0,0,0,0,0,0,0,37,159,
17,0,0,0,0,37,0,0,200,0,0,0,160,0,0,0,0,115,0,0,200,0,0,0,0,0,0,0,0,0,0,0,0,0,0,0,0,0,37,159,
17,0,0,0,0,37,0,0,231,0,0,0,160,0,0,0,0,115,0,0,0,0,0,0,0,0,0,0,0,0,0,0,0,0,0,0,0,0,37,159,
16,0,0,0,0,37,0,0,0,0,0,0,160,0,0,0,0,115,0,0,0,0,114,0,0,0,0,0,0,0,0,0,0,0,0,0,0,0,37,159,
16,0,0,0,0,37,0,0,0,0,246,0,160,0,0,0,0,116,0,0,0,0,115,285,286,0,0,0,0,286,0,0,0,0,0,0,0,0,37,159,
16,0,0,8,9,9,9,9,9,9,9,9,9,20,0,0,0,0,0,0,0,286,115,0,285,282,272,0,286,282,286,285,0,0,0,0,0,0,37,159,
17,0,0,12,1,1,1,1,1,1,1,1,1,16,0,0,0,0,0,286,282,0,116,272,282,0,285,286,272,0,285,272,285,0,0,0,0,0,37,159,
16,0,0,13,1,0,0,0,0,0,0,0,1,16,0,0,0,0,285,0,287,282,0,0,286,0,0,282,285,0,0,286,282,285,0,0,0,0,37,159,
16,0,0,13,1,0,0,0,0,0,0,0,1,17,0,0,0,285,282,272,0,284,272,0,282,292,282,0,114,286,0,285,0,286,0,0,0,0,37,159,
16,0,0,13,1,0,0,0,0,0,0,0,1,17,0,0,0,0,109,110,110,110,110,111,272,0,272,0,115,287,0,282,286,0,0,0,0,0,37,159,
17,0,0,12,1,0,0,0,0,0,0,0,1,16,0,0,272,286,287,282,0,282,292,0,0,286,293,285,115,0,282,0,285,0,0,0,0,0,37,159,
16,0,0,12,1,1,2,0,0,0,1,1,3,17,0,0,285,0,0,284,0,286,0,265,284,282,0,0,115,282,286,285,0,282,285,0,0,0,37,159,
16,0,0,11,15,1,1,0,0,0,1,1,15,18,0,0,286,0,285,0,291,0,287,0,288,278,265,283,116,285,272,0,285,286,0,204,0,0,37,159,
17,0,0,0,0,13,1,0,0,0,1,17,0,0,0,0,0,272,282,286,0,283,292,280,277,0,203,0,272,0,0,282,285,0,0,200,0,0,37,159,
17,0,0,0,0,13,1,0,0,0,1,16,0,0,0,0,285,286,0,272,282,272,117,282,272,288,200,289,0,272,285,286,0,0,0,0,0,0,37,159,
16,0,0,0,0,13,1,0,0,1,1,18,0,0,0,0,0,0,285,276,285,0,287,0,290,286,0,286,0,282,0,0,0,0,0,0,8,9,9,9,
16,0,0,0,0,12,1,0,0,1,16,0,0,0,0,0,0,194,0,286,0,276,280,0,284,0,282,0,117,285,0,0,8,9,9,9,10,1,1,1,
19,9,20,0,0,12,1,0,1,1,17,0,0,0,0,0,192,192,193,0,0,286,290,288,0,277,285,282,0,0,0,0,13,1,1,1,1,1,1,1,
1,1,17,0,0,13,1,1,1,1,17,0,0,0,0,193,192,192,192,188,0,285,0,114,288,0,0,0,0,0,0,0,13,1,1,1,1,1,1,1,
1,1,16,0,0,13,1,1,1,3,16,0,0,0,193,192,192,192,193,0,0,0,0,115,290,0,0,0,0,0,0,0,11,15,15,15,15,15,1,1,
1,1,16,0,0,11,15,15,15,15,18,0,0,0,0,0,193,188,0,0,0,0,0,115,0,0,0,0,0,0,0,0,0,0,0,0,0,0,13,1,
1,1,16,0,0,0,0,0,160,0,0,0,0,0,0,0,0,0,0,0,0,0,0,116,280,0,0,0,0,0,0,0,0,0,0,0,0,0,13,1,
1,1,17,0,0,0,0,0,160,0,0,0,0,0,0,0,0,0,0,0,0,0,0,280,0,0,0,117,0,0,0,0,0,0,0,0,0,0,12,1,
1,1,17,0,0,0,0,0,160,0,0,0,0,0,201,0,0,0,0,0,0,0,0,0,290,0,0,0,0,0,0,204,0,0,0,227,0,0,12,1,
1,1,17,0,0,0,0,0,160,0,0,0,0,0,200,0,0,0,0,0,0,0,0,290,280,0,0,0,0,0,0,200,0,0,0,0,0,0,13,1,
1,1,19,9,20,0,0,0,160,0,0,0,0,0,0,0,0,0,0,0,0,0,0,0,281,293,0,0,0,0,0,0,0,0,0,0,0,0,12,1,
1,1,1,1,19,9,9,9,9,9,9,20,0,0,0,0,8,9,9,9,9,9,9,9,9,9,9,20,0,0,0,246,0,0,0,8,9,9,10,1,
1,1,1,1,1,1,1,1,1,1,1,17,0,0,0,0,13,1,1,1,1,1,1,1,1,1,1,19,9,9,9,9,9,9,9,10,1,1,1,1,
0,0,0,0,0,0,0,0,0,0,1,17,0,0,0,0,13,1,1,1,1,1,1,1,1,1,1,1,1,1,1,1,1,1,1,1,1,1,1,1,
0,0,0,0,0,0,0,0,0,0,1,16,0,0,0,0,13,1,0,0,0,0,0,0,0,0,0,0,0,0,0,0,0,0,0,0,0,0,0,0,
0,0,0,0,0,0,0,0,0,0,1,16,0,0,0,0,13,1,0,0,0,0,0,0,0,0,0,0,0,0,0,0,0,0,0,0,0,0,0,0,
0,0,0,0,0,0,0,0,0,0,1,16,0,0,0,0,13,1,0,0,0,0,0,0,0,0,0,0,0,0,0,0,0,0,0,0,0,0,0,0,
0,0,0,0,0,0,0,0,0,0,1,17,0,0,0,0,13,1,0,0,0,0,0,0,0,0,0,0,0,0,0,0,0,0,0,0,0,0,0,0,
0,0,0,0,0,0,0,0,0,0,1,16,382,382,382,382,13,1,0,0,0,0,0,0,0,0,0,0,0,0,0,0,0,0,0,0,0,0,0,0,



md.torchDataVector.emplace_back(glm::ivec2{ 8, 6}, 13, 0, 0);
md.torchDataVector.emplace_back(glm::ivec2{ 26, 19}, 12, 12, 29);
md.torchDataVector.emplace_back(glm::ivec2{ 14, 29}, 10, 19, 5);
md.torchDataVector.emplace_back(glm::ivec2{ 31, 29}, 10, 0, 0);
md.torchDataVector.emplace_back(glm::ivec2{ 20, 6}, 10, 0, 0);
md.torchDataVector.emplace_back(glm::ivec2{ 35, 18}, 11, 0, 0);

