80
40
0,0,0,0,0,0,0,0,0,0,0,0,0,1,1,1,1,1,1,1,1,1,1,17,0,0,0,0,0,0,0,0,0,0,0,0,0,0,0,0,0,0,0,0,0,0,0,0,0,0,0,0,12,1,1,0,0,0,0,0,0,0,0,0,0,0,0,0,0,0,0,0,0,0,0,0,0,0,0,0,
0,0,0,0,0,0,0,0,0,0,0,0,0,1,1,1,15,15,15,15,1,1,1,17,0,0,0,0,0,0,0,0,0,0,0,0,0,0,0,0,0,0,0,0,0,0,0,0,0,0,0,0,13,1,1,0,0,0,0,0,0,0,0,0,0,0,0,0,0,0,0,0,0,0,0,0,0,0,0,0,
0,0,0,0,0,0,0,0,0,0,0,0,0,1,1,16,0,0,0,0,13,1,1,17,0,0,0,0,0,0,0,0,0,0,0,0,0,0,0,0,0,0,0,0,0,0,0,0,0,0,0,0,13,1,1,0,0,0,0,0,0,0,0,0,0,0,0,0,0,0,0,0,0,0,0,0,0,0,0,0,
0,0,0,0,0,0,0,0,0,0,0,0,0,1,1,16,0,0,0,0,12,6,1,16,0,0,0,0,0,0,0,0,0,0,0,0,0,0,0,0,0,204,0,0,0,0,0,0,0,0,0,0,12,1,1,0,0,0,0,0,0,0,0,0,0,0,0,0,0,0,0,0,0,0,0,0,0,0,0,0,
0,0,0,0,0,0,0,0,0,0,0,0,0,1,1,16,0,0,0,0,13,1,1,16,0,0,0,0,0,0,0,0,0,243,0,200,0,0,0,0,0,200,0,0,0,0,0,0,0,0,0,0,12,1,1,0,0,0,0,0,0,0,0,0,0,0,0,0,0,0,0,0,0,0,0,0,0,0,0,0,
0,0,0,0,0,0,0,0,0,0,0,0,1,1,1,17,0,0,0,196,12,1,1,17,0,0,0,0,8,9,9,9,9,9,20,0,0,0,0,0,0,0,0,0,0,0,0,0,0,0,0,0,12,1,1,0,0,0,0,0,0,0,0,0,0,0,0,0,0,0,0,0,0,0,0,0,0,0,0,0,
0,0,0,0,0,0,0,0,0,0,0,0,1,1,1,17,0,0,0,0,11,15,15,18,0,0,0,0,12,1,1,1,1,1,16,0,0,0,243,0,246,0,0,0,0,0,0,0,0,0,0,0,13,1,1,0,0,0,0,0,0,0,0,0,0,0,0,0,0,0,0,0,0,0,0,0,0,0,0,0,
0,0,0,0,0,0,0,0,0,0,0,1,1,1,1,16,0,0,0,0,0,354,199,0,0,0,0,0,13,1,1,5,1,1,19,9,9,9,9,9,9,9,9,20,0,0,0,0,0,0,0,0,13,1,1,0,0,0,0,0,0,0,0,0,0,0,0,0,0,0,0,0,0,0,0,0,0,0,0,0,
0,0,0,0,0,0,0,0,0,1,1,1,1,6,1,17,0,0,0,0,0,351,0,0,0,0,0,0,13,1,1,1,1,1,1,1,1,1,1,1,1,1,1,17,197,0,0,0,227,0,0,0,13,1,1,0,0,0,0,0,0,0,0,0,0,0,0,0,0,0,0,0,0,0,0,0,0,0,0,0,
0,0,1,1,1,1,2,1,1,1,1,1,1,1,1,16,197,0,0,0,0,0,0,0,0,0,0,196,12,1,1,1,1,1,1,1,1,3,1,1,1,1,1,16,0,0,0,0,0,0,0,0,12,1,1,0,0,0,0,0,0,0,0,0,0,0,0,0,0,0,0,0,0,0,0,0,0,0,0,0,
1,1,1,1,1,1,1,1,1,15,15,15,15,15,15,18,0,0,0,0,0,0,0,0,0,0,0,0,13,1,1,1,1,15,15,15,15,15,15,15,15,15,15,18,0,0,0,0,0,0,0,0,13,1,1,1,0,0,0,0,0,0,0,0,0,0,0,0,0,0,0,0,0,0,0,0,0,0,0,0,
1,1,7,1,1,15,15,15,18,0,0,0,0,0,0,0,0,0,0,0,203,0,0,0,0,0,0,0,13,1,1,1,16,0,0,0,0,189,0,0,0,0,189,0,0,0,0,0,0,0,0,0,12,1,1,1,1,0,0,0,0,0,0,0,0,0,0,0,0,0,0,0,0,0,0,0,0,0,0,0,
15,15,15,15,18,0,0,0,0,0,0,0,0,0,0,0,0,0,0,0,200,0,0,0,0,0,0,0,12,2,1,1,18,0,0,0,0,0,0,0,0,0,189,0,0,0,0,0,0,0,0,0,11,15,15,1,1,1,0,0,0,0,0,0,0,0,0,0,0,0,0,0,0,0,0,0,0,0,0,0,
0,0,0,0,0,0,0,0,0,0,0,0,0,0,0,0,0,0,0,0,0,0,0,0,0,0,0,0,11,15,1,17,0,0,0,0,0,0,0,0,0,0,0,0,0,0,0,0,0,0,0,0,0,0,0,12,1,1,1,1,1,1,1,1,0,0,0,0,0,0,0,0,0,0,0,0,0,0,0,0,
0,0,0,0,0,203,0,0,0,0,0,0,0,0,0,0,0,0,0,25,21,21,31,0,0,0,0,0,356,0,12,17,0,0,0,0,0,0,0,0,0,0,0,0,0,0,0,0,0,0,0,0,0,0,0,13,1,1,1,1,1,1,1,1,1,1,1,1,0,0,0,0,0,0,0,0,0,0,0,0,
0,0,0,0,0,200,0,0,0,0,0,0,0,0,0,0,0,0,0,33,23,23,35,0,0,0,0,0,198,0,13,16,0,0,0,0,0,189,0,0,0,0,0,0,0,0,0,0,0,0,0,0,0,0,0,11,15,15,15,15,15,15,15,15,15,15,1,1,1,0,0,0,0,0,0,0,0,0,0,0,
0,0,0,243,0,0,245,0,0,0,0,0,0,0,0,0,0,0,0,0,0,0,0,0,0,0,0,0,0,0,12,16,0,0,0,0,0,189,0,0,0,0,189,0,0,0,0,0,0,0,0,0,0,0,0,352,199,0,0,25,21,21,21,21,21,31,12,1,1,1,0,0,0,0,0,0,0,0,0,0,
9,9,9,9,9,9,9,9,9,9,9,9,20,0,0,0,0,0,0,0,0,0,0,0,0,0,0,0,0,0,11,18,0,0,0,0,0,189,0,0,0,0,189,0,0,0,0,0,0,0,0,0,0,0,0,355,0,0,0,27,0,0,0,0,0,29,13,1,1,1,0,0,0,0,0,0,0,0,0,0,
1,1,1,1,1,1,1,1,5,1,1,1,16,0,0,0,0,0,0,0,0,0,0,0,0,0,0,0,0,0,189,189,0,0,0,0,0,189,0,202,0,0,189,0,0,0,0,0,0,0,0,0,0,0,0,0,0,0,0,27,0,0,0,0,0,29,11,15,15,15,15,15,15,15,15,15,0,0,0,0,
1,1,1,1,1,1,1,1,1,1,1,1,17,197,0,0,0,0,0,0,0,0,0,0,0,0,0,0,0,0,189,189,0,0,0,0,0,189,0,200,0,0,189,0,0,0,0,0,0,0,0,0,0,0,0,0,0,0,0,27,0,0,0,0,0,29,147,143,143,143,153,0,0,0,0,0,13,0,0,0,
1,1,7,1,1,15,15,15,15,15,15,15,18,0,0,0,0,0,0,0,0,0,0,0,0,0,0,0,0,0,189,189,0,0,0,0,0,189,0,246,0,0,189,0,0,0,0,0,0,0,0,0,0,0,0,0,0,0,0,27,0,0,0,0,0,29,149,0,0,0,151,0,0,0,0,0,13,0,0,0,
1,1,1,1,18,0,198,0,0,199,25,21,31,0,0,0,0,0,0,0,0,0,0,0,0,0,0,0,0,0,189,189,0,0,0,0,0,85,83,83,83,83,92,0,0,0,0,0,0,26,22,22,22,32,0,0,0,0,0,27,0,0,0,0,0,29,149,0,0,0,151,0,0,203,0,0,13,0,0,0,
1,1,1,16,0,0,0,0,0,0,27,0,29,0,0,0,0,0,0,0,0,0,0,0,0,0,0,0,0,0,189,189,0,0,0,0,0,87,1,1,1,1,90,0,0,0,0,0,0,28,0,0,0,30,0,0,0,0,0,27,0,0,0,0,0,29,149,0,0,0,151,0,0,200,0,0,13,0,0,0,
1,1,1,16,0,0,0,0,0,0,27,0,29,0,0,0,0,0,0,0,0,0,0,0,0,0,0,0,85,83,83,83,92,0,0,0,0,88,84,84,84,84,89,0,0,0,0,0,0,34,24,24,24,36,0,0,0,0,0,33,23,23,23,23,23,35,155,145,145,145,157,0,0,0,0,0,13,0,0,0,
1,1,1,17,0,0,0,0,0,0,27,0,29,0,0,0,0,0,0,0,0,0,0,0,0,0,0,0,87,1,1,1,90,0,0,0,0,0,0,0,0,0,0,0,0,0,0,0,0,0,0,0,0,0,0,0,0,0,0,8,9,9,9,9,9,9,9,9,9,9,9,9,9,9,9,9,10,0,0,0,
1,1,1,17,0,0,231,0,0,0,27,0,29,0,0,0,0,0,0,0,0,0,0,0,0,0,0,0,88,84,84,84,89,0,0,0,0,0,0,0,0,0,0,0,0,0,0,0,0,0,0,0,0,0,0,0,0,0,0,12,1,1,1,1,1,1,1,1,1,1,0,0,0,0,0,0,0,0,0,0,
1,1,1,16,0,0,0,0,0,0,33,23,35,0,0,0,0,109,110,110,111,0,0,0,0,0,0,0,0,0,0,0,0,0,0,0,286,208,0,206,208,0,0,0,0,0,0,0,0,0,0,0,0,0,0,0,0,0,0,13,1,1,1,1,1,1,1,1,1,1,0,0,0,0,0,0,0,0,0,0,
1,1,1,19,20,0,0,204,0,0,147,143,153,0,0,0,0,0,0,0,0,0,0,206,0,0,206,0,0,0,0,0,0,0,289,206,0,0,206,0,0,206,0,0,0,0,0,0,0,0,0,0,0,0,0,0,0,0,196,13,1,1,1,0,0,0,0,0,0,0,0,0,0,0,0,0,0,0,0,0,
1,1,1,1,17,0,0,200,0,0,149,0,151,0,0,0,0,0,0,0,206,0,206,0,206,285,0,0,0,0,0,0,0,206,289,0,206,272,0,207,0,0,208,0,0,0,0,0,0,0,0,0,0,0,0,0,0,0,0,12,1,1,0,0,0,0,0,0,0,0,0,0,0,0,0,0,0,0,0,0,
1,1,1,1,16,0,0,0,0,0,149,0,151,0,0,0,0,0,206,272,0,0,0,208,0,206,0,206,0,0,0,0,0,208,0,284,0,0,0,0,0,204,0,0,0,0,0,0,0,0,0,0,0,0,0,0,0,0,0,12,1,1,0,0,0,0,0,0,0,0,0,0,0,0,0,0,0,0,0,0,
1,5,1,1,16,0,0,0,0,0,149,0,151,0,0,0,0,206,0,0,0,208,0,0,0,0,272,0,285,0,0,0,0,0,206,265,287,292,283,207,206,0,0,0,0,0,0,0,0,0,0,0,0,0,0,0,0,0,0,12,1,1,0,0,0,0,0,0,0,0,0,0,0,0,0,0,0,0,0,0,
1,1,1,1,17,0,0,246,0,0,155,145,157,0,0,0,0,0,0,0,272,0,0,206,272,0,0,0,206,0,0,0,0,0,0,277,206,0,0,0,272,206,0,207,0,0,0,0,0,0,0,0,0,0,0,0,0,0,0,12,1,0,0,0,0,0,0,0,0,0,0,0,0,0,0,0,0,0,0,0,
0,1,1,1,19,9,9,9,9,9,9,9,20,0,0,0,208,0,204,0,0,0,206,0,286,0,0,286,0,0,8,9,9,9,20,290,289,206,272,0,0,0,0,0,0,0,0,0,0,0,0,0,0,0,0,0,0,0,0,13,1,0,0,0,0,0,0,0,0,0,0,0,0,0,0,0,0,0,0,0,
0,0,1,1,1,1,1,1,1,1,1,1,16,0,0,0,0,0,0,206,206,206,0,208,0,289,0,0,195,0,12,1,1,1,17,278,0,208,0,206,0,208,0,0,0,0,0,0,0,0,0,0,0,0,0,0,0,0,0,13,1,0,0,0,0,0,0,0,0,0,0,0,0,0,0,0,0,0,0,0,
0,0,0,1,1,1,1,1,1,1,1,1,16,0,0,0,0,208,0,0,287,0,0,0,0,290,0,8,9,9,10,1,5,1,16,0,0,0,0,0,0,0,0,0,0,0,0,0,0,0,0,0,0,0,0,0,0,8,9,10,1,0,0,0,0,0,0,0,0,0,0,0,0,0,0,0,0,0,0,0,
0,0,0,0,0,0,0,0,0,0,0,1,16,0,0,0,0,0,0,0,290,0,0,0,0,277,0,12,1,2,1,1,1,1,19,20,0,0,0,0,0,0,0,0,0,0,0,0,0,0,0,0,0,0,0,0,0,12,1,1,1,0,0,0,0,0,0,0,0,0,0,0,0,0,0,0,0,0,0,0,
0,0,0,0,0,0,0,0,0,0,0,1,16,0,0,0,0,0,0,0,277,0,0,0,0,290,0,12,1,1,1,1,1,1,1,16,0,0,0,0,0,0,0,0,0,0,0,0,0,0,0,0,0,0,0,0,0,12,1,1,1,0,0,0,0,0,0,0,0,0,0,0,0,0,0,0,0,0,0,0,
0,0,0,0,0,0,0,0,0,0,0,1,16,0,0,0,195,0,0,0,281,243,0,0,0,281,0,13,1,0,0,0,0,1,1,69,216,216,216,216,216,216,216,216,216,216,216,216,216,216,216,216,216,216,216,216,216,67,1,1,1,0,0,0,0,0,0,0,0,0,0,0,0,0,0,0,0,0,0,0,
0,0,0,0,0,0,0,0,0,0,0,1,1,9,9,9,9,9,9,9,9,9,9,9,9,9,9,10,1,0,0,0,0,1,1,69,218,218,218,218,218,218,218,218,218,218,218,218,218,218,218,218,218,218,218,218,218,67,1,1,1,0,0,0,0,0,0,0,0,0,0,0,0,0,0,0,0,0,0,0,
0,0,0,0,0,0,0,0,0,0,0,1,1,1,1,1,1,1,1,1,1,1,1,1,1,1,1,1,0,0,0,0,0,0,1,70,218,218,218,218,218,218,218,218,218,218,218,218,218,218,218,218,218,218,218,218,218,68,1,1,1,0,0,0,0,0,0,0,0,0,0,0,0,0,0,0,0,0,0,0,



md.torchDataVector.emplace_back(glm::ivec2{ 39, 18}, 12, 7, 7);
md.torchDataVector.emplace_back(glm::ivec2{ 18, 32}, 11, 6, 0);
md.torchDataVector.emplace_back(glm::ivec2{ 5, 14}, 11, 16, 6);
md.torchDataVector.emplace_back(glm::ivec2{ 7, 27}, 9, 8, 9);
md.torchDataVector.emplace_back(glm::ivec2{ 20, 11}, 5, 5, 5);
md.torchDataVector.emplace_back(glm::ivec2{ 41, 3}, 15, 0, 0);
md.torchDataVector.emplace_back(glm::ivec2{ 73, 21}, 14, 32, 6);
md.torchDataVector.emplace_back(glm::ivec2{ 41, 29}, 10, 0, 0);

