40
40
0,0,0,0,0,0,0,0,0,0,0,0,0,0,0,0,0,0,0,0,0,0,0,0,0,0,0,0,0,0,0,0,0,0,0,0,0,0,0,0,
0,0,0,0,0,0,0,0,0,0,0,0,0,0,0,0,0,0,0,0,0,0,0,0,0,0,0,0,0,0,0,0,0,0,0,0,0,0,0,0,
0,0,0,0,0,0,0,0,0,0,0,0,0,0,0,0,0,0,0,0,0,0,0,0,0,0,0,0,0,0,0,0,0,0,0,0,0,0,0,0,
0,0,0,0,0,0,0,0,0,0,0,0,0,0,0,0,0,0,0,0,0,0,0,0,0,0,0,0,0,0,0,0,0,0,0,0,0,0,0,0,
0,0,0,0,0,0,0,0,0,0,0,0,0,0,0,0,0,0,0,0,0,0,0,0,0,0,0,0,0,0,0,0,0,0,0,0,0,0,0,0,
0,0,0,0,0,0,0,0,0,0,0,0,0,0,0,0,0,0,0,0,0,0,0,0,0,0,0,0,0,0,0,0,0,0,0,0,0,0,0,0,
0,0,0,0,0,0,0,0,0,0,0,0,0,8,9,9,9,9,9,9,9,9,9,9,9,20,0,0,0,0,0,0,0,0,0,0,0,0,0,0,
0,0,0,0,0,0,0,0,0,0,0,0,0,11,15,15,15,15,15,15,15,15,15,15,15,18,0,0,0,0,0,0,0,0,0,0,0,0,0,0,
0,0,0,0,0,0,0,0,0,0,0,0,0,0,0,0,0,0,0,0,0,0,205,0,279,0,0,0,0,0,0,0,0,0,0,0,0,0,0,0,
0,0,0,0,0,0,0,0,0,0,0,0,0,0,0,0,0,0,0,0,0,0,0,0,286,285,0,0,0,0,0,0,0,0,0,0,0,0,0,0,
0,0,0,0,0,0,0,0,0,0,0,0,0,0,0,0,0,0,0,0,0,0,0,272,280,0,205,0,0,0,0,0,0,0,0,0,0,0,0,0,
0,0,0,0,0,0,0,0,0,0,0,0,0,0,0,0,0,0,0,298,0,0,0,0,277,0,208,0,0,0,0,0,0,0,0,0,0,0,0,0,
0,0,0,0,0,0,0,0,0,0,0,366,8,9,20,365,0,0,301,117,0,0,0,366,85,83,92,365,0,0,0,0,0,0,0,0,0,0,0,0,
0,0,0,0,0,0,0,0,0,0,0,366,11,15,18,365,0,0,0,38,0,0,0,366,88,84,89,365,0,0,0,0,0,0,0,0,0,0,0,0,
0,0,0,0,0,0,0,0,0,0,0,0,0,37,0,0,0,0,0,38,0,0,0,0,0,37,0,0,0,0,0,0,0,0,0,0,0,0,0,0,
0,0,0,0,0,0,0,0,0,203,0,0,0,37,0,0,0,0,0,38,0,0,227,0,0,37,0,0,0,203,0,0,0,0,0,0,0,0,0,0,
0,0,0,0,0,0,0,0,0,0,0,0,0,37,0,0,0,0,0,38,0,0,289,293,0,37,0,0,0,0,0,0,0,0,0,0,0,0,0,0,
0,0,0,0,0,0,0,0,0,0,0,0,0,37,0,0,0,0,0,38,0,0,272,289,0,37,0,0,0,0,0,0,0,0,0,0,0,0,0,0,
0,0,0,0,0,0,0,0,248,0,0,195,0,37,0,248,0,0,0,38,0,0,0,277,293,37,0,0,195,0,195,0,195,0,0,0,0,0,0,0,
0,0,0,0,0,8,9,9,9,9,9,9,9,9,9,20,0,0,0,38,0,0,289,8,9,9,9,9,9,9,9,9,9,9,9,9,9,9,0,0,
0,0,0,0,0,13,5,1,1,1,1,1,5,4,4,17,197,0,301,117,0,286,0,12,5,4,3,1,1,1,1,1,1,1,1,1,1,1,0,0,
0,0,0,0,0,12,1,1,1,1,1,1,1,5,5,17,0,0,0,0,0,0,0,12,3,1,1,1,1,1,1,1,1,1,1,1,1,1,0,0,
0,0,0,0,0,13,1,1,1,1,1,1,1,1,1,16,292,0,0,0,0,0,0,12,1,1,1,1,1,1,1,1,1,1,1,1,1,1,0,0,
0,0,0,0,0,12,1,1,1,1,1,1,1,1,1,17,0,0,0,0,0,0,0,12,1,1,1,1,1,0,0,0,0,0,0,0,0,0,0,0,
0,0,0,0,0,12,1,1,1,1,1,1,1,1,1,19,20,300,0,0,0,0,8,10,1,1,1,1,1,0,0,0,0,0,0,0,0,0,0,0,
0,195,0,0,0,12,1,1,1,1,1,1,1,1,3,4,17,0,0,0,0,0,13,1,1,3,1,0,0,0,0,0,0,0,0,0,0,0,0,0,
9,9,9,9,9,10,1,1,1,1,1,1,1,1,3,4,16,0,0,0,0,301,13,1,1,1,1,0,0,0,0,0,0,0,0,0,0,0,0,0,
1,1,1,1,1,3,1,1,4,1,1,1,1,1,1,4,16,0,0,0,0,0,13,1,1,1,1,0,0,0,0,0,0,0,0,0,0,0,0,0,
1,1,1,1,1,1,1,1,1,1,1,1,1,1,1,1,17,300,0,0,0,0,13,1,1,1,1,0,0,0,0,0,0,0,0,0,0,0,0,0,
1,1,1,1,1,1,1,1,1,1,1,1,1,1,1,1,17,300,0,0,0,301,13,1,3,1,1,0,0,0,0,0,0,0,0,0,0,0,0,0,
0,0,0,0,0,0,0,0,0,0,1,3,1,1,1,1,16,0,0,0,0,0,13,1,1,4,1,0,0,0,0,0,0,0,0,0,0,0,0,0,
0,0,0,0,0,0,0,0,0,0,1,1,1,1,1,382,296,0,0,0,0,0,0,382,1,1,1,0,0,0,0,0,0,0,0,0,0,0,0,0,
0,0,0,0,0,0,0,0,0,0,1,1,0,0,0,382,0,0,0,0,0,0,0,382,1,1,1,0,0,0,0,0,0,0,0,0,0,0,0,0,
0,0,0,0,0,0,0,0,0,0,1,0,0,0,0,0,382,382,382,0,0,382,382,0,0,0,0,0,0,0,0,0,0,0,0,0,0,0,0,0,
0,0,0,0,0,0,0,0,0,0,0,0,0,0,0,0,0,0,0,0,0,0,0,0,0,0,0,0,0,0,0,0,0,0,0,0,0,0,0,0,
0,0,0,0,0,0,0,0,0,0,0,0,0,0,0,0,0,0,0,0,0,0,0,0,0,0,0,0,0,0,0,0,0,0,0,0,0,0,0,0,
0,0,0,0,0,0,0,0,0,0,0,0,0,0,0,0,0,0,0,0,0,0,0,0,0,0,0,0,0,0,0,0,0,0,0,0,0,0,0,0,
0,0,0,0,0,0,0,0,0,0,0,0,0,0,0,0,0,0,0,0,0,0,0,0,0,0,0,0,0,0,0,0,0,0,0,0,0,0,0,0,
0,0,0,0,0,0,0,0,0,0,0,0,0,0,0,0,0,0,0,0,0,0,0,0,0,0,0,0,0,0,0,0,0,0,0,0,0,0,0,0,
0,0,0,0,0,0,0,0,0,0,0,0,0,0,0,0,0,0,0,0,0,0,0,0,0,0,0,0,0,0,0,0,0,0,0,0,0,0,0,0,




