66
39
1,0,0,0,0,0,0,0,0,0,0,0,0,0,0,0,0,0,0,0,0,0,0,0,0,0,0,0,0,0,0,0,0,0,0,0,0,0,0,0,0,0,0,0,0,0,0,0,0,0,0,0,0,0,0,0,0,0,0,0,0,0,0,0,0,1,
1,0,0,0,0,0,0,0,0,0,0,0,0,0,0,0,0,0,0,0,0,0,0,0,0,0,0,0,0,0,0,0,0,0,0,0,0,0,0,0,0,0,0,0,0,0,0,0,0,0,0,0,0,0,0,0,0,0,0,0,0,0,0,0,0,1,
1,0,0,0,0,0,0,0,0,0,0,0,0,0,0,0,0,0,0,0,0,0,0,0,0,0,0,0,0,0,0,0,0,0,0,0,0,0,0,0,0,0,0,0,0,0,0,0,0,0,0,0,0,0,0,0,0,0,0,0,0,0,0,0,0,1,
1,0,0,0,220,0,0,0,0,0,0,0,220,220,0,0,0,0,0,0,0,0,0,0,267,0,0,0,0,0,0,0,0,0,0,0,0,195,0,0,195,195,0,195,0,0,0,0,0,0,0,0,0,0,0,0,0,0,0,0,232,0,0,232,0,1,
1,0,0,0,220,0,0,0,0,0,0,0,220,220,0,0,0,0,0,0,0,0,0,0,0,0,0,0,0,0,0,0,0,0,99,96,96,9,96,9,9,9,9,20,0,0,0,0,0,0,0,0,0,0,0,0,0,0,371,371,371,372,99,96,96,1,
1,0,0,0,221,0,0,0,0,0,0,0,220,220,0,0,0,0,0,0,0,0,0,0,0,0,0,0,191,0,0,202,0,0,98,1,1,14,1,61,61,61,1,17,197,0,0,0,0,0,0,0,0,0,0,0,0,0,0,0,0,0,98,7,1,1,
1,0,0,0,220,0,0,0,0,0,0,0,220,220,0,0,0,0,0,0,0,0,245,195,195,195,192,0,192,193,195,200,0,0,98,3,1,1,63,0,0,0,60,17,230,0,0,0,0,0,0,0,0,0,0,0,0,0,0,0,0,0,98,1,1,1,
1,0,0,0,220,0,0,0,0,0,0,0,220,220,0,0,0,202,0,0,0,0,8,9,9,9,66,0,57,9,9,9,96,96,100,1,1,1,63,0,0,0,60,17,370,371,0,0,0,0,0,0,0,0,0,0,0,0,232,0,190,97,98,1,1,1,
1,0,0,0,220,0,0,0,0,0,0,0,221,220,0,0,0,200,0,0,0,230,12,1,1,6,63,0,60,1,1,1,14,3,1,1,1,7,63,0,57,62,1,17,0,0,202,0,0,267,0,0,0,0,0,0,0,232,99,96,96,96,100,1,1,1,
1,0,0,0,220,0,0,0,0,0,0,0,221,220,0,0,0,373,371,371,371,372,12,14,1,1,64,0,59,61,61,61,61,61,61,61,61,1,63,0,60,1,14,17,197,0,200,0,0,0,0,0,0,0,0,0,371,372,87,1,1,7,1,1,1,1,
1,0,0,0,220,0,0,0,0,0,0,0,221,220,0,0,0,377,0,0,0,196,12,7,1,63,0,0,0,0,0,0,0,0,0,0,0,60,63,0,60,1,1,17,195,0,195,195,0,0,195,0,0,0,0,0,0,0,87,1,1,1,1,1,1,1,
1,0,0,0,221,0,0,0,191,0,0,0,220,220,0,0,371,371,373,0,0,0,12,2,1,63,0,0,0,0,0,0,0,0,0,0,0,59,64,0,59,61,1,19,9,9,9,9,9,9,9,20,197,0,0,0,0,0,87,1,1,1,1,1,1,1,
1,0,0,0,220,0,0,193,192,193,0,0,220,220,0,202,0,0,377,0,0,191,12,1,1,63,0,0,0,0,0,0,0,0,0,0,0,0,0,0,0,0,60,1,1,14,1,1,1,3,15,18,0,0,0,0,0,0,88,84,84,84,84,84,84,1,
1,0,0,0,221,0,193,192,214,192,191,0,220,220,0,200,0,195,377,190,0,230,12,14,1,1,62,62,62,66,374,374,374,374,374,374,374,57,62,62,62,62,1,1,0,0,0,0,1,17,198,199,0,0,0,0,0,0,0,0,0,0,0,0,0,1,
1,0,0,0,221,0,0,193,213,190,0,0,220,221,0,371,372,8,9,9,9,9,10,1,1,7,1,1,6,63,0,0,0,0,0,0,0,59,61,61,61,61,1,1,0,0,0,0,1,17,0,0,0,339,0,0,0,0,0,0,0,193,191,0,0,1,
1,0,0,0,221,0,0,0,213,0,0,0,220,220,0,0,0,12,14,3,1,1,14,1,1,1,1,1,1,63,0,0,0,0,0,0,0,0,0,0,0,0,60,1,0,348,0,0,1,19,20,0,0,0,0,191,0,0,191,191,192,192,192,193,0,1,
1,0,0,0,220,0,0,0,213,0,0,0,221,220,339,0,196,11,15,15,15,1,1,1,1,1,1,1,1,1,62,62,62,62,62,62,62,62,66,374,57,62,1,1,193,347,193,0,105,1,17,230,0,195,191,190,0,193,192,192,192,188,192,192,193,1,
1,0,0,0,220,0,0,0,213,0,0,0,221,220,0,0,0,198,199,0,0,87,2,1,1,1,1,1,1,1,1,1,1,1,1,1,1,1,63,0,60,1,16,0,192,347,192,0,79,1,19,9,73,9,73,73,73,73,73,73,75,192,192,192,192,1,
1,0,0,0,221,0,0,0,213,0,0,0,220,220,0,0,0,0,0,202,0,87,14,1,1,1,6,1,1,1,1,1,7,63,214,60,1,1,63,0,60,1,17,0,193,347,193,0,79,1,1,1,3,1,7,2,1,7,1,1,76,193,193,192,192,1,
1,229,0,0,221,0,0,0,213,191,0,0,220,220,0,0,0,0,195,200,195,87,1,1,1,1,1,61,61,61,61,61,61,64,213,60,1,1,63,0,60,1,17,0,0,347,0,372,79,1,1,1,1,1,1,1,1,1,1,1,76,0,0,193,80,1,
1,92,370,0,220,0,0,193,213,192,193,0,220,220,0,0,196,8,9,83,9,86,1,1,61,61,64,0,0,0,0,0,0,0,213,59,61,61,64,0,60,1,17,0,0,347,0,0,79,1,0,0,0,1,1,1,1,1,1,3,76,0,0,0,79,1,
1,90,0,0,221,0,193,192,213,192,192,191,220,221,0,0,191,12,3,1,14,1,1,63,0,0,0,0,0,0,0,0,0,0,213,0,0,0,0,0,60,1,17,195,191,347,0,230,79,1,0,0,0,1,1,7,61,61,61,61,77,0,0,0,78,1,
1,90,0,222,223,224,190,192,215,192,192,222,223,223,224,191,190,12,14,1,1,1,1,90,0,57,62,62,62,62,62,62,62,66,215,57,62,62,62,62,58,1,19,20,192,346,192,80,81,1,0,0,0,1,1,76,193,0,0,0,189,0,0,0,189,1,
1,69,216,225,219,226,216,216,219,216,216,225,219,219,226,216,216,67,1,1,1,1,1,63,0,87,1,1,1,1,1,1,1,69,219,67,1,1,1,1,1,1,1,140,345,345,345,141,1,1,0,0,0,1,1,76,192,192,193,0,0,0,202,0,189,1,
1,69,218,218,218,218,218,218,218,218,218,218,218,218,218,218,218,67,1,1,1,1,1,90,0,60,1,1,1,1,1,1,1,69,218,67,1,0,0,0,0,0,1,140,344,344,344,141,1,0,0,0,0,1,2,76,192,192,192,192,193,0,200,0,0,1,
1,69,218,218,218,218,218,218,218,218,218,218,218,218,218,218,218,67,1,1,1,1,84,89,0,88,84,84,84,84,1,1,1,69,218,67,1,0,0,0,0,0,1,140,344,344,344,141,1,0,0,0,0,1,1,65,73,73,73,73,73,73,75,0,0,1,
1,69,218,218,218,218,218,218,218,218,218,218,218,218,218,218,218,67,1,1,1,90,189,0,0,0,189,0,0,193,87,3,1,69,218,67,1,0,0,0,0,0,1,140,344,344,344,141,1,0,0,0,0,1,1,3,1,1,1,3,7,1,76,0,0,1,
1,69,218,218,218,218,218,218,218,218,218,218,218,218,218,218,218,67,1,1,1,90,189,0,0,190,0,229,193,192,87,1,1,69,218,67,1,0,0,0,0,0,1,140,344,344,344,141,1,0,0,0,0,1,1,1,1,1,1,1,1,1,140,345,345,1,
1,69,218,218,218,218,218,218,218,218,218,218,218,218,218,218,218,67,1,1,1,90,0,0,85,83,83,92,371,372,87,1,1,70,218,68,1,0,0,0,0,0,1,140,344,344,344,141,1,0,0,0,0,0,0,0,0,0,0,0,0,1,140,344,344,1,
1,69,218,218,218,218,218,218,218,218,218,218,218,218,218,218,218,67,1,1,1,90,0,0,87,3,1,90,0,0,87,1,1,1,217,1,0,0,0,0,0,0,1,140,344,344,344,141,1,0,0,0,0,0,0,0,0,0,0,0,0,1,140,344,344,1,
1,69,218,218,218,218,218,218,218,218,218,218,218,218,218,218,218,67,1,1,2,90,230,0,87,1,1,90,0,0,87,1,1,1,1,1,0,0,0,0,0,0,1,140,344,344,344,141,1,0,0,0,0,0,0,0,0,0,0,0,0,1,140,344,344,1,
1,69,218,218,218,218,218,218,218,218,218,218,218,218,218,218,218,67,1,1,1,90,370,371,88,84,84,89,0,0,87,3,1,0,0,0,0,0,0,0,0,0,1,140,344,344,344,141,1,0,0,0,0,0,0,0,0,0,0,0,0,1,1,142,142,1,
1,70,218,218,218,218,218,218,218,218,218,218,218,218,218,218,218,67,1,1,1,90,0,193,192,192,192,193,0,0,87,1,1,0,0,0,0,0,0,0,0,0,1,140,344,344,344,141,1,0,0,0,0,0,0,0,0,0,0,0,0,0,0,0,0,1,
1,70,217,218,218,218,218,218,218,218,218,218,218,218,218,218,218,67,1,1,1,90,190,229,193,193,0,0,190,230,87,1,1,0,0,0,0,0,0,0,0,0,1,1,142,142,142,1,1,0,0,0,0,0,0,0,0,0,0,0,0,0,0,0,0,1,
1,1,1,217,217,217,218,218,218,218,217,217,217,218,218,217,218,68,1,1,1,91,83,83,92,0,0,85,83,83,86,1,1,0,0,0,0,0,0,0,0,0,1,1,1,1,1,1,1,0,0,0,0,0,0,0,0,0,0,0,0,0,0,0,0,1,
1,1,1,1,1,1,218,218,218,217,1,1,1,217,217,1,217,1,1,1,1,1,1,1,90,0,0,87,1,1,1,1,1,0,0,0,0,0,0,0,0,0,0,0,0,0,0,0,0,0,0,0,0,0,0,0,0,0,0,0,0,0,0,0,0,1,
1,0,0,0,0,1,217,217,217,1,1,1,1,1,1,1,1,1,0,0,0,0,0,1,140,345,345,141,1,0,0,0,0,0,0,0,0,0,0,0,0,0,0,0,0,0,0,0,0,0,0,0,0,0,0,0,0,0,0,0,0,0,0,0,0,1,
1,0,0,0,0,0,1,1,1,0,0,0,0,0,0,0,0,0,0,0,0,0,0,1,140,344,344,141,1,0,0,0,0,0,0,0,0,0,0,0,0,0,0,0,0,0,0,0,0,0,0,0,0,0,0,0,0,0,0,0,0,0,0,0,0,1,
0,0,0,0,0,0,0,0,0,0,0,0,0,0,0,0,0,0,0,0,0,0,0,1,140,344,344,141,1,0,0,0,0,0,0,0,0,0,0,0,0,0,0,0,0,0,0,0,0,0,0,0,0,0,0,0,0,0,0,0,0,0,0,0,0,0,






md.torchDataVector.emplace_back(glm::ivec2{ 62, 23}, 20, 0, 0);
md.torchDataVector.emplace_back(glm::ivec2{ 46, 8}, 20, 0, 0);
md.torchDataVector.emplace_back(glm::ivec2{ 31, 5}, 21, 0, 0);
md.torchDataVector.emplace_back(glm::ivec2{ 15, 12}, 10, 0, 0);
md.torchDataVector.emplace_back(glm::ivec2{ 17, 7}, 10, 0, 0);
md.torchDataVector.emplace_back(glm::ivec2{ 19, 18}, 21, 0, 0);
