40
40
0,0,0,0,0,0,0,0,0,0,0,0,0,0,0,0,0,0,0,0,0,0,0,0,0,0,0,0,0,0,0,0,0,0,0,0,0,0,0,0,
0,0,0,0,0,0,0,0,0,0,0,0,0,0,0,0,0,0,0,0,0,0,0,0,0,0,0,0,0,0,0,0,0,0,0,0,0,0,0,0,
0,0,0,0,0,0,0,0,0,0,0,0,0,0,0,0,0,0,0,0,0,0,0,0,0,0,0,0,0,0,0,0,0,0,0,0,0,0,0,0,
0,0,0,0,0,0,0,0,0,0,0,0,0,0,0,0,0,0,0,0,0,0,0,0,0,0,0,0,0,0,0,0,0,0,0,0,0,0,0,0,
0,0,0,0,0,0,0,0,0,0,0,0,0,0,0,0,0,0,0,0,0,0,0,0,0,0,0,0,0,0,0,0,0,0,0,0,0,0,0,0,
0,0,0,0,0,0,0,0,0,0,0,0,0,0,0,0,0,0,0,0,0,0,0,0,0,0,0,0,0,0,0,0,0,0,0,0,0,0,0,0,
0,0,0,0,0,0,0,0,0,0,0,0,0,0,0,0,0,0,0,0,0,0,0,0,0,0,0,0,0,0,0,0,0,0,0,0,0,0,0,0,
0,0,0,0,0,0,0,0,0,0,0,0,0,0,0,0,0,0,0,0,0,0,0,0,0,0,0,0,0,0,0,0,0,0,0,0,0,0,0,0,
0,0,0,0,0,0,0,0,0,0,0,0,0,0,0,0,0,0,0,0,0,0,0,0,0,0,0,0,0,0,0,0,0,0,0,0,0,0,0,0,
0,0,0,0,0,0,0,0,0,0,0,0,0,0,0,0,0,0,0,0,0,0,0,0,0,0,0,0,0,0,0,0,0,0,0,0,0,0,0,0,
0,0,0,0,0,0,0,0,0,0,0,0,0,0,0,0,0,0,0,0,0,0,0,0,0,0,0,0,0,0,0,0,0,0,0,0,0,0,0,0,
0,0,0,0,0,0,0,0,0,0,0,0,0,0,0,0,0,0,0,0,0,0,0,0,0,0,0,0,0,0,0,0,0,0,0,0,0,0,0,0,
0,0,0,0,0,0,0,0,0,0,0,0,0,0,0,0,0,0,0,0,0,0,0,0,0,0,0,0,0,0,0,0,0,0,0,0,0,0,0,0,
0,0,0,0,0,0,0,0,0,0,0,0,0,0,0,0,0,0,0,0,0,0,0,0,0,0,0,0,0,0,0,0,0,0,0,0,0,0,0,0,
0,0,0,0,0,0,0,0,0,0,0,0,0,0,0,0,0,0,0,0,191,192,192,193,192,0,0,0,0,0,0,0,0,0,0,0,0,0,0,0,
0,0,0,0,0,0,0,0,0,0,0,0,0,0,0,0,0,0,0,193,192,192,192,192,192,192,0,0,0,0,0,0,0,0,0,0,0,0,0,0,
0,0,0,0,0,0,0,0,0,0,0,0,0,0,0,0,0,0,0,0,192,193,0,191,192,0,0,0,0,0,0,0,0,0,0,0,0,0,0,0,
0,0,0,0,0,0,0,0,0,0,0,0,0,0,0,0,0,0,0,0,0,194,219,192,0,0,0,0,0,0,0,0,0,0,0,0,0,0,0,0,
0,0,0,0,0,0,0,0,0,0,0,0,0,0,0,0,0,0,0,0,0,0,221,0,0,0,0,0,0,0,0,0,0,0,0,0,0,0,0,0,
0,0,0,0,0,0,0,0,0,0,0,0,0,0,0,0,0,0,0,0,0,0,221,0,0,0,0,0,0,0,0,0,0,0,0,0,0,0,0,0,
0,0,0,0,0,0,0,0,0,0,0,0,0,0,0,0,0,0,0,0,0,222,223,224,0,0,0,0,0,0,0,0,0,0,0,0,0,0,0,0,
0,0,0,0,0,0,0,0,0,0,0,0,0,0,0,0,0,0,0,0,0,225,219,226,0,0,0,0,0,0,0,0,0,0,0,0,0,0,0,0,
0,0,0,0,0,0,0,0,0,0,0,0,0,0,0,0,0,0,0,193,192,220,217,220,192,191,0,0,0,0,0,0,258,0,0,0,97,99,96,102,
0,0,0,195,243,0,195,243,195,0,0,0,0,0,0,0,0,0,194,192,191,220,0,221,193,193,191,0,0,0,0,99,96,96,96,96,96,100,1,103,
0,0,8,9,9,9,9,9,20,197,0,0,0,0,0,0,0,191,192,191,0,220,202,223,224,192,193,0,191,0,0,98,1,1,3,1,1,1,1,103,
0,196,12,1,1,1,1,14,17,0,0,0,0,0,193,0,0,0,193,0,0,220,200,219,226,191,0,0,0,0,0,12,1,1,1,1,1,1,1,103,
0,0,12,1,1,1,1,1,90,256,0,193,191,0,0,0,0,0,0,0,0,220,0,217,220,0,0,0,0,0,0,98,1,1,1,1,6,1,1,76,
0,276,12,14,1,1,15,15,89,0,191,192,0,0,0,202,0,0,0,0,0,221,0,193,220,0,0,0,0,0,0,11,61,61,61,1,1,1,1,103,
0,0,11,15,15,18,0,0,193,192,192,192,192,0,0,200,0,0,0,0,222,223,224,0,220,0,0,0,202,0,0,0,296,0,239,78,61,61,61,77,
0,0,198,351,352,357,191,192,192,194,192,192,192,191,0,0,0,0,0,0,225,219,226,0,220,0,0,0,200,0,0,0,0,0,0,0,296,0,251,0,
0,0,0,198,199,191,192,192,192,192,193,192,193,192,0,0,0,0,0,0,220,217,220,0,221,0,0,0,0,0,0,0,0,240,0,0,0,0,0,0,
0,0,0,0,0,192,192,191,193,8,9,9,83,9,83,83,92,256,0,0,220,0,220,0,220,0,0,0,0,0,0,80,73,73,73,73,73,73,73,75,
0,0,0,0,0,193,191,0,191,12,1,1,1,1,1,1,17,0,0,0,220,0,221,0,220,0,0,0,0,0,0,79,1,1,1,1,1,1,1,76,
0,0,0,0,0,0,0,0,196,12,1,1,1,1,5,1,17,0,0,222,223,222,223,224,223,224,0,80,73,73,73,58,1,3,1,1,1,1,1,76,
0,0,0,0,0,0,0,0,0,12,1,14,1,1,1,1,69,216,216,225,219,225,219,226,219,226,216,67,5,1,1,1,1,1,1,1,1,1,1,76,
0,0,0,0,0,0,0,0,0,13,1,1,1,1,1,1,69,218,218,218,218,218,218,218,218,218,218,67,1,1,1,1,1,1,1,1,1,1,1,76,
0,0,0,0,0,0,0,0,0,1,1,1,1,1,1,1,70,218,218,218,218,218,218,218,218,218,218,68,1,1,1,1,1,1,1,1,1,1,1,76,
0,0,0,0,0,0,0,0,0,0,0,0,0,0,0,0,0,217,218,218,218,218,218,218,218,218,217,1,1,1,1,1,1,1,1,1,1,1,1,74,
0,0,0,0,0,0,0,0,0,0,0,0,0,0,0,0,0,0,217,217,217,217,217,217,217,217,0,1,1,1,1,1,1,1,1,1,1,1,1,1,
0,0,0,0,0,0,0,0,0,0,0,0,0,0,0,0,0,0,0,0,0,0,0,0,0,0,0,0,0,0,0,0,0,0,0,0,0,0,0,0,






md.torchDataVector.emplace_back(glm::ivec2{ 28, 28}, 17, 0, 0);
md.torchDataVector.emplace_back(glm::ivec2{ 22, 24}, 15, 0, 0);
md.torchDataVector.emplace_back(glm::ivec2{ 15, 27}, 15, 0, 0);
